//MAP CONVERTED BY dmm2tgm.py THIS HEADER COMMENT PREVENTS RECONVERSION, DO NOT REMOVE
"ao" = (
/obj/structure/machinery/telecomms/relay/preset/tower/mapcomms{
	broadcasting = 0;
	receiving = 0;
	tcomms_machine = 0
	},
/obj/effect/landmark/tutorial_tracking_marker{
	tracking_target_type = /obj/structure/machinery/telecomms/relay/preset/tower/mapcomms
	},
/turf/open/floor/plating/asteroidwarning/southwest,
/area/misc/tutorial/no_baselight/unpowered)
"be" = (
/obj/structure/window/framed/strata,
/obj/structure/machinery/door/poddoor/hybrisa/ultra_reinforced_door{
	dir = 4
	},
/turf/open/floor/strata/multi_tiles/southeast,
/area/misc/tutorial/no_baselight/unpowered)
"bW" = (
/obj/structure/machinery/power/smes/buildable{
	capacity = 1e+006;
	dir = 1;
	pixel_x = 1;
	pixel_y = 1
	},
/turf/open/floor/strata/orange_icorner/west,
/area/misc/tutorial/no_baselight/unpowered)
"ca" = (
/obj/structure/machinery/door/airlock/almayer/maint{
	dir = 2
	},
/obj/effect/landmark/tutorial_tracking_marker{
	tracking_target_type = /obj/structure/machinery/door/airlock/almayer/maint
	},
/turf/open/floor/strata/multi_tiles/southwest,
/area/misc/tutorial/no_baselight/unpowered)
"cy" = (
/obj/structure/machinery/power/apc/upgraded/power/north,
/turf/open/floor/strata/multi_tiles/southeast,
/area/misc/tutorial/no_baselight/unpowered)
"cH" = (
/obj/structure/flora/grass/tallgrass/jungle_alt/corner,
/turf/open/gm/coast/dirt/south,
/area/misc/tutorial/no_baselight/unpowered)
"cP" = (
/obj/structure/machinery/door/airlock/almayer/maint{
	dir = 2;
	locked = 1;
	no_panel = 1;
	damage_cap = 12000;
	needs_power = 0;
	breakable = 0;
	unslashable = 1;
	explo_proof = 1
	},
/turf/closed/wall/strata_outpost/reinforced/hull,
/area/misc/tutorial/no_baselight/unpowered)
"do" = (
/obj/effect/decal/cleanable/dirt,
/obj/effect/decal/warning_stripes{
	icon_state = "E";
	pixel_x = 1
	},
/obj/effect/decal/warning_stripes{
	icon_state = "W";
	pixel_x = -1
	},
/turf/open/floor/strata/multi_tiles/west,
/area/misc/tutorial/no_baselight/unpowered)
"eh" = (
/obj/structure/flora/bush/ausbushes/reedbush{
	pixel_x = -7;
	pixel_y = 10
	},
/obj/structure/platform_decoration/metal/strata,
/obj/structure/blocker/invisible_wall/water,
/turf/open/gm/coast/dirt/west,
/area/misc/tutorial/no_baselight/unpowered)
"eD" = (
/obj/effect/landmark/tutorial_bottom_left,
/turf/open/floor/plating,
/area/misc/tutorial/no_baselight/unpowered)
"fh" = (
/turf/closed/wall/strata_outpost/reinforced,
/area/misc/tutorial/no_baselight/unpowered)
"fx" = (
/obj/structure/platform/metal/strata/west,
/turf/open/gm/dirt/brown,
/area/misc/tutorial/no_baselight/unpowered)
"fR" = (
/turf/open/floor/plating/asteroidwarning/northeast,
/area/misc/tutorial/no_baselight/unpowered)
"gu" = (
/obj/structure/platform/metal/strata/west,
/obj/structure/platform/metal/strata/east,
/obj/effect/decal/hybrisa/lattice,
/obj/structure/blocker/invisible_wall/water,
/turf/open/gm/river/soro{
	no_overlay = 1
	},
/area/misc/tutorial/no_baselight/unpowered)
"hp" = (
/obj/structure/platform/metal/strata/west,
/turf/open/gm/coast/dirt/beachcorner/north_west,
/area/misc/tutorial/no_baselight/unpowered)
"hs" = (
/obj/structure/flora/bush/ausbushes/reedbush{
	pixel_x = -2;
	pixel_y = 4
	},
/obj/structure/flora/grass/tallgrass/jungle_alt/corner,
/turf/open/gm/coast/dirt/south,
/area/misc/tutorial/no_baselight/unpowered)
"hA" = (
/obj/structure/machinery/cm_vending/clothing/engi/tutorial,
/obj/effect/landmark/tutorial_tracking_marker{
	tracking_target_type = /obj/structure/machinery/cm_vending/clothing/engi/tutorial
	},
/turf/open/floor/strata/orange_tile,
/area/misc/tutorial/no_baselight/unpowered)
"iq" = (
/obj/effect/decal/strata_decals/catwalk/prison{
	keep_as_object = 1
	},
/turf/open/gm/river/soro{
	no_overlay = 1
	},
/area/misc/tutorial/no_baselight/unpowered)
"iz" = (
/obj/structure/flora/bush/ausbushes/reedbush{
	pixel_x = -8;
	pixel_y = 14
	},
/obj/structure/platform/metal/strata/east,
/obj/structure/blocker/invisible_wall/water,
/turf/open/gm/coast/dirt/beachcorner2/north_west,
/area/misc/tutorial/no_baselight/unpowered)
"iT" = (
/obj/structure/machinery/door/poddoor/hybrisa/ultra_reinforced_door{
	dir = 4
	},
/turf/open/floor/almayer/pod_landing_floor,
/area/misc/tutorial/no_baselight/unpowered)
"je" = (
/obj/structure/platform/metal/strata/west,
/obj/structure/machinery/light/double{
	dir = 8
	},
/turf/open/gm/coast/dirt/beachcorner2/north_west,
/area/misc/tutorial/no_baselight/unpowered)
"jF" = (
/obj/structure/platform/stone/soro/west,
/turf/closed/wall/strata_ice/jungle,
/area/misc/tutorial/no_baselight/unpowered)
"jI" = (
/obj/structure/flora/bush/ausbushes/reedbush{
	pixel_x = -1
	},
/obj/structure/platform/metal/strata/west,
/turf/open/gm/dirt/brown,
/area/misc/tutorial/no_baselight/unpowered)
"jU" = (
/obj/structure/machinery/power/power_generator/reactor/colony{
	desc = "A high-tech thermoelectric generator fueled by a superheated uranium rod.";
	name = "\improper G-17 Thermoelectric Generator"
	},
/obj/structure/cable/yellow{
	d1 = 2;
	d2 = 4;
	icon_state = "0-8";
	layer = 2.1
	},
/turf/open/floor/almayer/pod_landing_floor,
/area/misc/tutorial/no_baselight/unpowered)
"kg" = (
/obj/structure/flora/bush/ausbushes/reedbush{
	pixel_x = -8
	},
/obj/structure/flora/grass/tallgrass/jungle_alt/corner{
	dir = 10
	},
/obj/structure/platform_decoration/stone/soro,
/turf/open/gm/coast/dirt/south,
/area/misc/tutorial/no_baselight/unpowered)
"kZ" = (
/obj/structure/machinery/cryopod/no_store/right,
/turf/open/floor/strata/orange_edge/east,
/area/misc/tutorial/no_baselight/unpowered)
"lm" = (
/obj/structure/flora/grass/tallgrass/jungle_alt/corner,
/turf/open/auto_turf/strata_grass/layer1,
/area/misc/tutorial/no_baselight/unpowered)
"lB" = (
/turf/open/floor/strata/orange_edge/west,
/area/misc/tutorial/no_baselight/unpowered)
"lV" = (
/obj/structure/flora/bush/ausbushes/reedbush{
	pixel_x = -1;
	pixel_y = 11
	},
/turf/open/gm/coast/dirt/north,
/area/misc/tutorial/no_baselight/unpowered)
"my" = (
/obj/structure/platform/metal/strata/north,
/obj/structure/platform/metal/strata/west,
/obj/structure/blocker/invisible_wall/water,
/turf/open/gm/river/soro,
/area/misc/tutorial/no_baselight/unpowered)
"mX" = (
/obj/structure/platform/metal/strata/west,
/obj/structure/platform/metal/strata/east,
/obj/effect/decal/heavy_cable/cable_horizontal,
/obj/effect/decal/hybrisa/lattice,
/obj/structure/blocker/invisible_wall/water,
/turf/open/floor/strata/multi_tiles/southeast,
/area/misc/tutorial/no_baselight/unpowered)
"nC" = (
/obj/structure/platform/stone/soro/east,
/obj/structure/platform/stone/soro,
/turf/open/gm/coast/dirt/beachcorner/south_east,
/area/misc/tutorial/no_baselight/unpowered)
"oe" = (
/obj/structure/platform_decoration/stone/soro/west,
/turf/open/gm/river/soro,
/area/misc/tutorial/no_baselight/unpowered)
"ot" = (
/turf/closed/wall/strata_ice/jungle,
/area/misc/tutorial/no_baselight/unpowered)
"pd" = (
/turf/closed/wall/strata_outpost,
/area/misc/tutorial/no_baselight/unpowered)
"pm" = (
/obj/structure/flora/bush/ausbushes/reedbush{
	pixel_x = -1;
	pixel_y = -16
	},
/obj/structure/platform/stone/soro/east,
/turf/open/gm/coast/dirt/north,
/area/misc/tutorial/no_baselight/unpowered)
"qj" = (
/obj/structure/platform_decoration/metal/strata,
/obj/structure/blocker/invisible_wall/water,
/turf/open/gm/coast/dirt/beachcorner2/north_west,
/area/misc/tutorial/no_baselight/unpowered)
"qL" = (
/obj/structure/prop/colorable_rock/colorable{
	color = "#9d7766";
	pixel_x = 1;
	dir = 4
	},
/obj/structure/flora/jungle/vines/heavy,
/obj/structure/platform/stone/soro/east,
/turf/open/gm/dirt/brown/variant_2,
/area/misc/tutorial/no_baselight/unpowered)
"qX" = (
/obj/structure/platform_decoration/metal/strata/east,
/obj/structure/platform/stone/soro,
/obj/structure/blocker/invisible_wall/water,
/turf/open/gm/coast/dirt/south,
/area/misc/tutorial/no_baselight/unpowered)
"rM" = (
/obj/structure/platform_decoration/metal/strata/north,
/obj/structure/platform/stone/soro/north,
/obj/structure/blocker/invisible_wall/water,
/turf/open/gm/river/soro,
/area/misc/tutorial/no_baselight/unpowered)
"rP" = (
/obj/structure/machinery/colony_floodlight,
/turf/open/floor/strata/multi_tiles/southwest,
/area/misc/tutorial/no_baselight/unpowered)
"rU" = (
/obj/structure/platform/stone/soro/north,
/turf/open/gm/river/soro,
/area/misc/tutorial/no_baselight/unpowered)
"sL" = (
/obj/structure/surface/table/reinforced/prison{
	color = "#98a3ab"
	},
/obj/effect/spawner/random/toolbox{
	pixel_x = -3;
	pixel_y = -1
	},
/obj/effect/spawner/random/toolbox{
	pixel_x = -3;
	pixel_y = 11
	},
/turf/open/floor/strata/multi_tiles,
/area/misc/tutorial/no_baselight/unpowered)
"tA" = (
/obj/structure/flora/grass/tallgrass/jungle_alt/corner{
	dir = 6
	},
/turf/open/auto_turf/strata_grass/layer1,
/area/misc/tutorial/no_baselight/unpowered)
"tG" = (
/obj/structure/platform/metal/strata,
/obj/structure/blocker/invisible_wall/water,
/turf/open/gm/river/soro,
/area/misc/tutorial/no_baselight/unpowered)
"tW" = (
/obj/structure/flora/jungle/thickbush/large_jungle_bush{
	color = "#648c57";
	icon_state = "bush3";
	pixel_x = -17;
	pixel_y = -4
	},
/obj/structure/flora/bush/ausbushes/var3/fullgrass,
/obj/structure/flora/grass/tallgrass/jungle_alt/corner{
	dir = 10
	},
/obj/structure/flora/bush/ausbushes/var3/brflowers,
/turf/open/auto_turf/strata_grass/layer1,
/area/misc/tutorial/no_baselight/unpowered)
"uu" = (
/obj/structure/platform/metal/strata/north,
/obj/structure/platform_decoration/stone/soro,
/obj/effect/mist/steam{
	pixel_x = -11;
	pixel_y = -1
	},
/obj/structure/flora/bush/ausbushes/var3/stalkybush,
/obj/structure/blocker/invisible_wall/water,
/turf/open/gm/coast/dirt/beachcorner2/south_east,
/area/misc/tutorial/no_baselight/unpowered)
"vs" = (
/obj/structure/platform_decoration/stone/soro/east,
/turf/open/gm/river/soro,
/area/misc/tutorial/no_baselight/unpowered)
"vD" = (
/obj/structure/platform_decoration/metal/strata/west,
/obj/structure/platform/stone/soro,
/obj/structure/blocker/invisible_wall/water,
/turf/open/gm/coast/dirt/south,
/area/misc/tutorial/no_baselight/unpowered)
"vQ" = (
/turf/closed/wall/strata_outpost/reinforced/hull,
/area/misc/tutorial/no_baselight/unpowered)
"wR" = (
/obj/effect/decal/strata_decals/catwalk/prison{
	keep_as_object = 1
	},
/obj/structure/lattice,
/obj/effect/decal/heavy_cable/cable_vertical,
/obj/effect/hybrisa/misc/fake/wire{
	dir = 8
	},
/obj/effect/hybrisa/misc/fake/wire/yellow{
	dir = 8;
	pixel_y = 4
	},
/turf/open/gm/river/soro{
	no_overlay = 1;
	base_river_slowdown = 0
	},
/area/misc/tutorial/no_baselight/unpowered)
"xp" = (
/obj/structure/platform/metal/strata/north,
/obj/structure/platform/metal/strata/east,
/obj/structure/platform/stone/soro,
/obj/structure/blocker/invisible_wall/water,
/turf/open/gm/coast/dirt/south,
/area/misc/tutorial/no_baselight/unpowered)
"yi" = (
/obj/structure/machinery/cm_vending/gear/engi/tutorial,
/obj/effect/landmark/tutorial_tracking_marker{
	tracking_target_type = /obj/structure/machinery/cm_vending/gear/engi/tutorial
	},
/turf/open/floor/strata/orange_tile,
/area/misc/tutorial/no_baselight/unpowered)
"yQ" = (
/obj/structure/platform/metal/strata/north,
/obj/structure/blocker/invisible_wall/water,
/turf/open/gm/river/soro,
/area/misc/tutorial/no_baselight/unpowered)
"zs" = (
/obj/structure/flora/grass/tallgrass/jungle_alt/corner,
/obj/structure/platform/stone/soro/west,
/obj/structure/flora/bush/ausbushes/reedbush{
	pixel_x = 10
	},
/turf/open/gm/coast/dirt/south,
/area/misc/tutorial/no_baselight/unpowered)
"zu" = (
/obj/structure/machinery/cm_vending/sorted/tech/comtech_tools,
/turf/open/floor/strata/orange_tile,
/area/misc/tutorial/no_baselight/unpowered)
"An" = (
/obj/structure/platform/stone/soro/west,
/obj/structure/platform/stone/soro,
/obj/structure/platform_decoration/metal/strata/west,
/obj/structure/blocker/invisible_wall/water,
/turf/open/gm/river/soro,
/area/misc/tutorial/no_baselight/unpowered)
"Ba" = (
/turf/closed/wall/strata_ice/rock,
/area/misc/tutorial/no_baselight/unpowered)
"Bq" = (
/obj/structure/platform/metal/strata/east,
/obj/structure/blocker/invisible_wall/water,
/turf/open/gm/river/soro,
/area/misc/tutorial/no_baselight/unpowered)
"BY" = (
/obj/structure/machinery/cryopod/no_store{
	layer = 3.1;
	pixel_y = 13
	},
/turf/open/floor/strata/orange_edge/west,
/area/misc/tutorial/no_baselight/unpowered)
"CH" = (
/obj/structure/machinery/fuelcell_recycler/full,
/turf/open/floor/strata/orange_edge,
/area/misc/tutorial/no_baselight/unpowered)
"CT" = (
/obj/structure/machinery/vending/cigarette/koorlander{
	density = 0;
	pixel_x = -5;
	pixel_y = 16
	},
/obj/structure/reagent_dispensers/water_cooler/stacks{
	density = 0;
	pixel_x = -11;
	pixel_y = 3
	},
/obj/effect/decal/warning_stripes{
	icon_state = "NE-out";
	pixel_x = 1;
	pixel_y = 1
	},
/obj/effect/decal/warning_stripes{
	icon_state = "NW-out";
	pixel_x = -1;
	pixel_y = 1
	},
/obj/structure/blocker/invisible_wall,
/turf/open/floor/strata/orange_cover,
/area/misc/tutorial/no_baselight/unpowered)
"Dp" = (
/turf/open/floor/strata/multi_tiles/southwest,
/area/misc/tutorial/no_baselight/unpowered)
"Fe" = (
/turf/open/floor/plating/asteroidwarning/southeast,
/area/misc/tutorial/no_baselight/unpowered)
"FL" = (
/obj/structure/machinery/door/airlock/almayer/engineering/autoname{
	glass = 0
	},
/turf/open/floor/strata/multi_tiles/southwest,
/area/misc/tutorial/no_baselight/unpowered)
"Gl" = (
/obj/item/fuel_cell,
/obj/structure/surface/rack{
	color = "#98a3ab"
	},
/turf/open/floor/strata/orange_icorner/north,
/area/misc/tutorial/no_baselight/unpowered)
"HT" = (
/obj/structure/surface/table/almayer,
/obj/structure/machinery/light/double{
	dir = 4
	},
/obj/effect/landmark/tutorial_tracking_marker{
	tracking_target_type = /obj/structure/machinery/light/double
	},
/turf/open/floor/strata/orange_cover,
/area/misc/tutorial/no_baselight/unpowered)
"Ix" = (
/obj/structure/machinery/cryopod/no_store,
/turf/open/floor/strata/orange_edge/west,
/area/misc/tutorial/no_baselight/unpowered)
"IT" = (
/obj/structure/platform/stone/soro/west,
/obj/structure/platform/metal/strata/east,
/obj/structure/blocker/invisible_wall/water,
/turf/open/gm/river/soro,
/area/misc/tutorial/no_baselight/unpowered)
"JX" = (
/turf/open/gm/coast/dirt/beachcorner,
/area/misc/tutorial/no_baselight/unpowered)
"Kf" = (
/obj/structure/flora/bush/ausbushes/reedbush{
	pixel_x = -14;
	pixel_y = 12
	},
/obj/structure/platform/metal/strata/east,
/obj/structure/blocker/invisible_wall/water,
/turf/open/gm/coast/dirt/west,
/area/misc/tutorial/no_baselight/unpowered)
"Kq" = (
/turf/open/floor/strata/multi_tiles/southeast,
/area/misc/tutorial/no_baselight/unpowered)
"KQ" = (
/obj/structure/barricade/handrail/strata{
	dir = 8
	},
/obj/structure/cable/yellow{
	d1 = 2;
	d2 = 4;
	icon_state = "0-8";
	layer = 2.1
	},
/obj/structure/machinery/power/power_generator/reactor/colony{
	desc = "A high-tech thermoelectric generator fueled by a superheated uranium rod.";
	name = "\improper G-17 Thermoelectric Generator"
	},
/turf/open/floor/almayer/pod_landing_floor,
/area/misc/tutorial/no_baselight/unpowered)
"Lq" = (
/obj/structure/platform/metal/strata,
/obj/structure/platform/metal/strata/east,
/obj/structure/blocker/invisible_wall/water,
/turf/open/gm/river/soro,
/area/misc/tutorial/no_baselight/unpowered)
"Md" = (
/obj/structure/platform/stone/soro,
/obj/effect/mist/steam{
	pixel_x = 5;
	pixel_y = 12
	},
/obj/structure/prop/colorable_rock/colorable{
	color = "#9d7766";
	dir = 4;
	pixel_x = 15;
	pixel_y = 6
	},
/obj/structure/blocker/invisible_wall/water,
/turf/open/gm/coast/dirt/south,
/area/misc/tutorial/no_baselight/unpowered)
"Ms" = (
/obj/structure/prop/colorable_rock/colorable{
	color = "#9d7766";
	pixel_x = -1;
	pixel_y = -12;
	dir = 6
	},
/obj/structure/platform/stone/soro/east,
/obj/structure/platform/stone/soro/north,
/turf/open/gm/coast/dirt/north,
/area/misc/tutorial/no_baselight/unpowered)
"Nr" = (
/obj/structure/flora/bush/ausbushes/reedbush{
	pixel_x = -1;
	pixel_y = -4
	},
/obj/structure/platform/stone/soro/north,
/obj/structure/platform/stone/soro/west,
/turf/open/gm/coast/dirt/north,
/area/misc/tutorial/no_baselight/unpowered)
"NH" = (
/obj/effect/decal/cleanable/dirt,
/obj/effect/decal/warning_stripes{
	icon_state = "E";
	pixel_x = 1
	},
/obj/effect/decal/warning_stripes{
	icon_state = "W";
	pixel_x = -1
	},
/obj/structure/closet/toolcloset{
	pixel_y = 9
	},
/obj/structure/blocker/invisible_wall,
/turf/open/floor/strata/multi_tiles/west,
/area/misc/tutorial/no_baselight/unpowered)
"Pp" = (
/obj/structure/flora/bush/ausbushes/reedbush{
	pixel_x = 8;
	pixel_y = -2
	},
/turf/open/gm/coast/dirt/beachcorner,
/area/misc/tutorial/no_baselight/unpowered)
"Qu" = (
/obj/structure/machinery/power/smes/buildable{
	capacity = 1e+006;
	dir = 1;
	pixel_x = 1
	},
/turf/open/floor/strata/orange_edge,
/area/misc/tutorial/no_baselight/unpowered)
"Sx" = (
/obj/structure/platform/metal/strata/north,
/obj/structure/platform/metal/strata/east,
/obj/structure/blocker/invisible_wall/water,
/turf/open/gm/river/soro,
/area/misc/tutorial/no_baselight/unpowered)
"UF" = (
/turf/open/floor/plating/asteroidwarning/northwest,
/area/misc/tutorial/no_baselight/unpowered)
"UQ" = (
/obj/effect/decal/warning_stripes{
	icon_state = "E";
	pixel_x = 1
	},
/obj/effect/decal/warning_stripes{
	icon_state = "W";
	pixel_x = -1
	},
/turf/open/floor/strata/multi_tiles/west,
/area/misc/tutorial/no_baselight/unpowered)
"VF" = (
/obj/structure/platform/metal/strata,
/obj/structure/platform_decoration/stone/soro/west,
/obj/structure/blocker/invisible_wall/water,
/turf/open/gm/river/soro,
/area/misc/tutorial/no_baselight/unpowered)
"Xp" = (
/obj/structure/platform/metal/strata,
/obj/structure/platform/metal/strata/west,
/obj/structure/blocker/invisible_wall/water,
/turf/open/gm/river/soro,
/area/misc/tutorial/no_baselight/unpowered)
"Xu" = (
/turf/open/floor/strata/multi_tiles/west,
/area/misc/tutorial/no_baselight/unpowered)
"Ye" = (
/obj/effect/landmark/tutorial_tracking_marker{
	tracking_target_type = /turf/open/floor/strata/multi_tiles/west
	},
/turf/open/floor/strata/multi_tiles/west,
/area/misc/tutorial/no_baselight/unpowered)
"Yj" = (
/obj/structure/surface/table/almayer,
/obj/structure/machinery/light/double{
	dir = 4
	},
/turf/open/floor/strata/orange_tile,
/area/misc/tutorial/no_baselight/unpowered)
"Yk" = (
/obj/structure/foamed_metal,
/turf/open/floor/plating,
/area/misc/tutorial/no_baselight/unpowered)
"YV" = (
/obj/structure/platform/metal/strata/west,
/obj/structure/flora/bush/ausbushes/var3/fernybush,
/obj/structure/machinery/light/double{
	dir = 8
	},
/turf/open/gm/dirt/brown/variant_5/south,
/area/misc/tutorial/no_baselight/unpowered)
"YY" = (
/obj/effect/decal/strata_decals/catwalk/prison{
	keep_as_object = 1
	},
/obj/effect/decal/heavy_cable/cable_horizontal,
/turf/open/gm/river/soro{
	no_overlay = 1;
	base_river_slowdown = 0
	},
/area/misc/tutorial/no_baselight/unpowered)
"Zm" = (
/obj/structure/platform/metal/strata/east,
/obj/structure/flora/bush/ausbushes/var3/brflowers,
/turf/open/auto_turf/strata_grass/layer1,
/area/misc/tutorial/no_baselight/unpowered)
"Zz" = (
/obj/structure/machinery/cryopod/tutorial{
	dir = 1;
	pixel_y = 13;
	layer = 3.1
	},
/obj/effect/landmark/tutorial_tracking_marker{
	tracking_target_type = /obj/structure/machinery/cryopod/tutorial
	},
/turf/open/floor/strata/orange_edge/east,
/area/misc/tutorial/no_baselight/unpowered)

(1,1,1) = {"
vQ
vQ
vQ
vQ
vQ
vQ
vQ
vQ
vQ
vQ
vQ
vQ
vQ
"}
(2,1,1) = {"
vQ
Ba
Ba
fh
iT
iT
iT
fh
Ba
Ba
Ba
eD
vQ
"}
(3,1,1) = {"
vQ
Ba
Ba
YV
fx
jI
hp
je
Ba
Ba
Ba
Ba
vQ
"}
(4,1,1) = {"
vQ
Ba
Ba
JX
eh
Kf
iz
Bq
IT
An
Ba
Ba
vQ
"}
(5,1,1) = {"
vQ
Ba
Pp
qj
Lq
pd
cy
YY
KQ
yQ
zs
jF
vQ
"}
(6,1,1) = {"
vQ
Ba
lV
tG
UF
ao
Kq
YY
KQ
yQ
cH
ot
vQ
"}
(7,1,1) = {"
vQ
qL
pm
VF
fR
Fe
Kq
YY
jU
yQ
hs
ot
vQ
"}
(8,1,1) = {"
vQ
Ba
Ba
rM
Xp
rP
Kq
YY
jU
yQ
kg
ot
vQ
"}
(9,1,1) = {"
vQ
Ba
Nr
vs
tG
gu
wR
gu
pd
uu
nC
Ba
vQ
"}
(10,1,1) = {"
vQ
Ba
Ms
oe
tG
sL
Kq
Qu
my
qX
tA
ot
vQ
"}
(11,1,1) = {"
vQ
Ba
Ba
rU
tG
iq
Kq
CH
yQ
Md
lm
ot
vQ
"}
(12,1,1) = {"
vQ
Ba
Ba
mX
mX
Gl
Dp
bW
Sx
vD
tW
ot
vQ
"}
(13,1,1) = {"
vQ
pd
pd
pd
pd
be
FL
be
pd
xp
Zm
ot
vQ
"}
(14,1,1) = {"
vQ
Ix
BY
CT
pd
zu
lB
lB
vQ
vQ
vQ
vQ
vQ
"}
(15,1,1) = {"
vQ
NH
do
UQ
ca
Ye
Xu
Xu
cP
Yk
Yk
Yk
vQ
"}
(16,1,1) = {"
vQ
kZ
Zz
HT
pd
hA
Yj
yi
vQ
Yk
Yk
Yk
vQ
"}
(17,1,1) = {"
vQ
vQ
vQ
vQ
vQ
vQ
vQ
vQ
vQ
vQ
vQ
vQ
vQ
"}
